17 20
|---------|--------|
|....@...........C.|
|.|-------|.|---.--|
|.|C.....C|.|.....F|
|.|--|.|--|.|--|.|-|
|.............P..|.|  
|----|.|---|.|---|.| 
|....|.|.....|C..|.| 
|.|--|.|--|.|--|.|.|
|.|.......|.|.....F|
|----.-----.-----.-|
|..................|
|.|----------...---|
|C|.......F........|
|.|----...---------|
|.......P.........C|
|------------------|